//MAP CONVERTED BY dmm2tgm.py THIS HEADER COMMENT PREVENTS RECONVERSION, DO NOT REMOVE
"a" = (
/turf/open/dark_filler,
/area/rogue/outdoors)
"U" = (
/turf/closed/mineral/rogue/bedrock,
/area/rogue/outdoors)

(1,1,1) = {"
U
a
a
a
a
a
a
a
a
a
"}
(2,1,1) = {"
a
a
a
a
a
a
a
a
a
a
"}
(3,1,1) = {"
a
a
a
a
a
a
a
a
a
a
"}
(4,1,1) = {"
a
a
a
a
a
a
a
a
a
a
"}
(5,1,1) = {"
a
a
a
a
a
a
a
a
a
a
"}
(6,1,1) = {"
a
a
a
a
a
a
a
a
a
a
"}
(7,1,1) = {"
a
a
a
a
a
a
a
a
a
a
"}
(8,1,1) = {"
a
a
a
a
a
a
a
a
a
a
"}
(9,1,1) = {"
a
a
a
a
a
a
a
a
a
a
"}
(10,1,1) = {"
a
a
a
a
a
a
a
a
a
a
"}

(1,1,2) = {"
a
a
a
a
a
a
a
a
a
a
"}
(2,1,2) = {"
a
a
a
a
a
a
a
a
a
a
"}
(3,1,2) = {"
a
a
a
a
a
a
a
a
a
a
"}
(4,1,2) = {"
a
a
a
a
a
a
a
a
a
a
"}
(5,1,2) = {"
a
a
a
a
a
a
a
a
a
a
"}
(6,1,2) = {"
a
a
a
a
a
a
a
a
a
a
"}
(7,1,2) = {"
a
a
a
a
a
a
a
a
a
a
"}
(8,1,2) = {"
a
a
a
a
a
a
a
a
a
a
"}
(9,1,2) = {"
a
a
a
a
a
a
a
a
a
a
"}
(10,1,2) = {"
a
a
a
a
a
a
a
a
a
a
"}

(1,1,3) = {"
a
a
a
a
a
a
a
a
a
a
"}
(2,1,3) = {"
a
a
a
a
a
a
a
a
a
a
"}
(3,1,3) = {"
a
a
a
a
a
a
a
a
a
a
"}
(4,1,3) = {"
a
a
a
a
a
a
a
a
a
a
"}
(5,1,3) = {"
a
a
a
a
a
a
a
a
a
a
"}
(6,1,3) = {"
a
a
a
a
a
a
a
a
a
a
"}
(7,1,3) = {"
a
a
a
a
a
a
a
a
a
a
"}
(8,1,3) = {"
a
a
a
a
a
a
a
a
a
a
"}
(9,1,3) = {"
a
a
a
a
a
a
a
a
a
a
"}
(10,1,3) = {"
a
a
a
a
a
a
a
a
a
a
"}
